MMMMMMMMMMMMMMMMMMMMMMMMMMMMMMMMMMMMMMMMMMMMMMMMMMMMMMMMMMMMMMMMMMMMMMMMMMMMMMM~~~~~~~~~~~~~~~~~~~~~~~~~~~~
MMMMMMMMMMMMMMMMMMMMMMMMMMMMMMMMMMMMMMMMMMMMMMMMMMMMMMMMMMMMMMMMMMMMMMMM~~~~~~~~~~~~~~~~~~~~~~~~~~~~~~~~~~~
MMMMMMMMMMMMMMMMMMMMMMMMMMMMMMMMMMMMMMMMMMMMMMMMMMMMMMMMMMMMMMMMMMM~~~~~~~~~~~~~~~~~~~~~~~~~~~~~~~~~~~~~~~~
MMMMMMMMMMMMMMMMMMMMMMMMMMMMMMMMMMMMMMMMMMMMMMMMMMMMMMMMMMMMM~~~~~~~~~~~~~~~~~~~~~~~~~~~~~~~~~~~~~~~~~~~~~~
MMMMMMMMMMMMMMMMMMMMMMMMMMMMMMMMMMMMMMMMMMMMMMMMMMMMM...........~~~~~~~~~~~~~~~~~~~~~~~~~~~~~~~~~~~~~~~~~~~
MMMMMMMMMMMMMMMMMMMMMMMMMMMMMMMMMMMMMMMMMMMMMMMM.....................~~~~~~~~~~~~~~~~~~~~~~~~~~~~~~~~~~~~~~
MMMMMMMMMMMMMMMMMMMMMMMMMMMMMMMMMMMMMMMMMMMMMM...........................~~~~~~~~~~~~~~~~~~~~~~~~~~~~~~~~~~
MMMMMMMMMMMMMMMMMMMMMMMMMMMMMMMMMMMMMMMMMMMM~~~~~~~#.#~~~~~~~~~.............~~~~~~~~~~~~~~~~~~~~~~~~~~~~~~~
MMMMMMMMMMMMMMMMMMMMMMMMMMMMMMMMMMMMMMMMMM~~~~~~~~~#.#~~~~~~~~~~~~~............~~~~~~~~~~~~~~~~~~~~~~~~~~~~
MMMMMMMMMMMMMMMMMMMMMMMMMMMMMMMMMMMMMMMM~~~~~~~~~~~#.#~~~~~~~~~~~~~~~~............~~~~~~~~~~~~~~~~~~~~~~~~~
MMMMMMMMMMMMMMMMMMMMMMMMMMMMMMMMMMMMMM~~~~~~~~~~~~~#.#~~~~~~~~~~~~~~~~~~~~............~~~~~~~~~~~~~~~~~~~~~
MMMMMMMMMMMMMMMMMMMMMMMMMMMMMMMMM~~~~~~~~~~~~~~...........~~~~~~~~~~~~~~~~~~~~~...........~~~~~~~~~~~~~~~~~
MMMMMMMMMMMMMMMMMMMMMMMMMMMMMM~~~~~~~~~~......................~~~~~~~~~~~~~~~~~~~~~...ttt...~~~~~~~~~~~~~~~
MMMMMMMMMMMMMMMMMMMMMMMMMM~~~~~~~~~~.......#################......~~~~~~~~~~~~~~~~~~~tttttt..~~~~~~~~~~~~~~
MMMMMMMMMMMMMMMMMMMMMMM~~~~~~~~~~~.........##....#.@.#....##.........~~~~~~~~~~~~~~~~~ttttt...~~~~~~~~~~~~~
MMMMMMMMMMMMMMMMMMM~~~~~~~~~~~~.............#.............#............################.ttt....~~~~~~~~~~~~
MMMMMMMMMMMMMMttt~~~~~~~~~~~~~..............#.............#......................................~~~~~~~~~~
MMMMMMMMMMMM...ttt~~~~~~~~~~~...............#.............#............################.tttttttt...~~~~~~~~
MMMMMMMMMM.....ttt~~~~~~~~~~~~.............##.....#.#.....##...........~~~~~~~~~~~~~~~tttttttttttt..~~~~~~~
MMMMMMMM.........tt~~~~~~~~~~~.............########.########...........~~~~~~~~~~~~~~tttttttttttt...~~~~~~~
MMMMM.............tt~~~~~~~~~~~~......................................~~~~~~~~~~~~~~tttttttttttt.....~~~~~~
MMMM...............tt~~~~~~~~~~~~....................................~~~~~~~~~~~~~~..tttttttttt......~~~~~~
MMM_................t~~~~~~~~~~~~~~...............................~~~~~~~~~~~~~~......tttttt........~~~~~~~
MMMM..................~~~~~~~~~~~~~~~~.......................~~~~~~~~~~~~~~~~~.........ttt.........~~~~~~~~
MMMMM.....................~~~~~~~~~~~~~~~~~~~~~~~#.#~~~~~~~~~~~~~~~~~~~~~~~......................~~~~~~~~~~
MMMMMM............................~~~~~~~~~~~~~~~#.#~~~~~~~~~~~~~~~~~..........................~~~~~~~~~~~~
MMMMMMMMM..............................~~~~~~~~~~#.#~~~~~~~~~~..........................~~~~~~~~~~~~~~~~~~~
MMMMMMMMMMMMM...............................~~~~~#.#~~~~.........................~~~~~~~~~~~~~~~~~~~~~~~~~~
MMMMMMMMMMMMMMMMMM.........................................................~~~~~~~~~~~~~~~~~~~~~~~~~~~~~~~~
MMMMMMMMMMMMMMMMMMMMMMMMM..........................................MMMMMM~~~~~~~~~~~~~~~~~~~~~~~~~~~~~~~~~~
MMMMMMMMMMMMMMMMMMMMMMMMMMMMMMMMMMMM.....................MMMMMMMMMMMMMMMMMMMM~~~~~~~~~~~~~~~~~~~~~~~~~~~~~~
MMMMMMMMMMMMMMMMMMMMMMMMMMMMMMMMMMMMMMMMMM_MMMMMMMMMMMMMMMMMMMMMMMMMMMMMMMMMMMMMMMM~~~~~~~~~~~~~~~~~~~~~~~~